WWWWWWWWWWWWWWWWWWW
W........W........W
W........W........W
W........O........W
W........W........WWWWWWWWWWWWWWWWWWW
W........W..................O.......W
W........W........WWWWWWWWWWWWWWWWW.W
WWWWW...WWWWWW....W               W.W
W...O....W...W....W              WW.WW
W........WO.......W              W...W
W........W...W....W              W.P.W
W........WWWWW....W              W...W
W............W....W              WWWWW
W............WO...W
W........W...W....W
WWWWWWWWWWWWWWWWWWW
