WWWWWWWWWWWWWWWWWWW
W........W........W
W........W........W
W........O........W
W........W........WWWWWWWWWWWWWWWWWWWWWWW
W........W..................O...........W
W........W........WWWWWWWWWWWWWWWWWWWWW.W
WWWWW...WWWWWW....W                   W.W
W...O....W...W....W                 WWW.WWW
W........WO.......W                 W.....W
W........W...W....W                 W..P..W
W........WWWWW....W                 W.....W
W............W....W                 WWWWWWW
W............WO...W
W........W...W....W
WWWWWWWWWWWWWWWWWWW
